Y_+__#___+
__#__#_R__
__________
#_R_##_#__
#___##____
__________
__##_R_#__
__##___#_+
__________
_+___#____