Y_#____+_#
__#_##____
____R__#__
_######___
______+#__
_#####_#__
_#_+_#___R
_#_#_#___+
___#_____#
##########