##########
Y________+
#####___##
_+______R_
##___#####
__R______+
#####___##
+_______R_
#___######
##_______+