Y________+
_#######__
_#_+______
_#_#_#_#_R
_#_#_#_#__
_#_#R#_#__
_#___+_#__
_#######__
__________
+________R