Y____#####
##______##
+______R_+
__####____
_________R
______####
+R____#__+
____#_____
__________
_+_____R__