Y_+____+_R
__#____#__
__#____#__
__________
R_##__##__
__##__##_R
__________
__#____#__
__#____#__
_+____+___