Y________+
__##______
__________
____R_____
__+_______
______##__
__________
___##____+
__________
_+________