Y#+_______
_#________
_#_______+
_#######_#
_______#_#
_______#_R
_#___#_#_#
_#_R_#___#
_#___#####
_+________