Y________+
______R___
__________
___##__+__
_R____R___
___##_____
__________
_+____R___
___##_____
_______+__