Y#_+_R_#_+
_#_#_#_#_#
___#_#___#
##_#_#_###
+__R_____R
###_####_#
__#_R____#
_R#_##_#_#
__+____#_+
##########